"CHR","POS","start","end","start-end","mid","D","Res","Yes-No"
"3",818175,818175,1096009,277834,957092,0.0318181818181817,0.0336269015212169,"N"
"3",1469160,1469160,1592765,123605,1530962.5,0.287749287749288,0.151348651348651,"N"
"3",1592839,1592839,1716562,123723,1654700.5,0.222614840989399,0.251832111925383,"N"
"3",1767555,1767555,1968406,200851,1867980.5,0.271604938271605,0.322475570032573,"N"
"3",1968598,1968598,2211785,243187,2090191.5,0.13135593220339,0.129979035639413,"N"
"3",2211790,2211790,2453415,241625,2332602.5,0.276657060518732,0.305246422893482,"N"
"3",2453418,2453418,2671724,218306,2562571,0.00371057513914667,0.00408441116405722,"N"
"3",3204846,3204846,3705395,500549,3455120.5,0.320754716981132,0.301576872536137,"N"
"3",3705407,3705407,4162774,457367,3934090.5,0.305295950155763,0.257105378224749,"N"
"3",4162787,4162787,4343028,180241,4252907.5,0.196491228070175,0.118393234672304,"N"
"3",4552303,4552303,5431844,879541,4992073.5,0.346975088967971,0.272727272727273,"N"
"3",5985965,5985965,6522159,536194,6254062,0.0529247910863511,0.0445312500000001,"N"
"3",6933048,6933048,7278637,345589,7105842.5,0.497005988023952,0.381901840490797,"N"
"3",8121130,8121130,8799555,678425,8460342.5,0.515492957746479,0.412626832018038,"S"
"3",8799582,8799582,8878163,78581,8838872.5,0.112426035502958,0.157894736842105,"N"
"3",8878207,8878207,9176223,298016,9027215,0.740181268882175,0.479608482871126,"S"
"3",9176243,9176243,9320492,144249,9248367.5,0.788235294117647,0.503338898163606,"S"
"3",9320713,9320713,9740244,419531,9530478.5,0.575700934579439,0.365073093638878,"N"
"3",10284423,10284423,10943220,658797,10613821.5,0.262103505843072,0.180806142034549,"N"
"3",10943322,10943322,11236624,293302,11089973,0.592391304347826,0.245035593855377,"N"
"3",11237468,11237468,11654568,417100,11446018,0.254071661237785,0.251477700161204,"N"
"3",12884078,12884078,13282875,398797,13083476.5,0.159420289855072,0.112799088492214,"N"
"3",13282885,13282885,13471998,189113,13377441.5,0.317316409791478,0.278514588859417,"N"
"3",13692723,13692723,14351218,658495,14021970.5,0.428985507246377,0.274412855377009,"N"
"3",14351511,14351511,14942124,590613,14646817.5,0.287018917155904,0.22169969768223,"N"
"3",14942152,14942152,14945011,2859,14943581.5,0.353182751540041,0.479108635097493,"S"
"3",14945218,14945218,15051346,106128,14998282,0.277936962750716,0.242904841402337,"N"
"3",16011614,16011614,16012278,664,16011946,0.0643015521064301,0.100694444444444,"N"
"3",16012290,16012290,16072665,60375,16042477.5,0.577205882352941,0.416814159292036,"S"
"3",16072669,16072669,16096363,23694,16084516,0.186320754716981,0.343976777939042,"N"
"3",16096365,16096365,16471163,374798,16283764,0.0664523043944268,0.0410596026490068,"N"
"3",16471198,16471198,16688357,217159,16579777.5,0.825396825396825,0.255737704918033,"N"
"3",16688389,16688389,16971513,283124,16829951,0.0976676384839646,0.0770114942528736,"N"
"3",16971541,16971541,17191698,220157,17081619.5,0.210191082802548,0.16010781671159,"N"
"3",17191749,17191749,17296466,104717,17244107.5,0.127694859038143,0.0801526717557254,"N"
"3",18021267,18021267,18163313,142046,18092290,0.122983870967742,0.100164203612479,"N"
"3",18232567,18232567,18336422,103855,18284494.5,0.179130434782609,0.161695447409733,"N"
"3",18760422,18760422,18920635,160213,18840528.5,0.249512670565302,0.384384384384384,"N"
"3",18920639,18920639,19256215,335576,19088427,0.318681318681319,0.33043950081389,"N"
"3",19256538,19256538,19289471,32933,19273004.5,0.593220338983051,0.513726556129383,"S"
"3",19423195,19423195,19784979,361784,19604087,0.430604982206406,0.413911060433295,"S"
"3",19785086,19785086,19951087,166001,19868086.5,0.565217391304348,0.370605004751346,"N"
"3",19951508,19951508,20186632,235124,20069070,0.255380200860832,0.19903093551994,"N"
"3",20955943,20955943,21463051,507108,21209497,0.254901960784313,0.27432590855803,"N"
"3",21463453,21463453,21929936,466483,21696694.5,0.0583333333333333,0.0513133781307267,"N"
"3",22056871,22056871,22163629,106758,22110250,0.0293577981651377,0.0256547300908607,"N"
"3",22572392,22572392,23279888,707496,22926140,0.89618320610687,0.765985210961287,"S"
"3",23279896,23279896,23787577,507681,23533736.5,0.247894103489771,0.270577933450087,"N"
"3",23787963,23787963,24236201,448238,24012082,0.382142857142857,0.311046511627907,"N"
"3",24281891,24281891,24323103,41212,24302497,0.280434782608696,0.48314606741573,"S"
"3",24323116,24323116,24751463,428347,24537289.5,0.217552533992584,0.1437125748503,"N"
"3",25327823,25327823,25863858,536035,25595840.5,0.558441558441559,0.270157068062827,"N"
"3",25863866,25863866,26451487,587621,26157676.5,0.0326086956521737,0.0353287536800782,"N"
"3",26451506,26451506,26523600,72094,26487553,0.0704697986577184,0.122211445198836,"N"
"3",26584183,26584183,26804651,220468,26694417,0.433628318584071,0.384313725490196,"N"
"3",26806057,26806057,27555694,749637,27180875.5,0.408963585434174,0.298772169167804,"N"
"3",27555888,27555888,27834297,278409,27695092.5,0.748905109489051,0.365384615384615,"N"
"3",27834355,27834355,28626914,792559,28230634.5,0.392484342379958,0.214285714285714,"N"
"3",28832133,28832133,28923078,90945,28877605.5,0.607843137254902,0.348706411698538,"N"
"3",28923081,28923081,29476664,553583,29199872.5,0.333333333333333,0.286131386861314,"N"
"3",29476927,29476927,29546193,69266,29511560,0.928825622775801,0.460588235294118,"S"
"3",29546203,29546203,29971037,424834,29758620,0.75199203187251,0.621911037891268,"S"
"3",29971886,29971886,30048967,77081,30010426.5,0.608527131782946,0.540137614678899,"S"
"3",30049015,30049015,30163559,114544,30106287,0.79296875,0.438287153652393,"S"
"3",30163763,30163763,30849083,685320,30506423,0.0462184873949577,0.0649606299212595,"N"
"3",30849114,30849114,31468904,619790,31159009,0.701369863013698,0.376009791921664,"N"
"3",31468905,31468905,32030315,561410,31749610,0.632183908045977,0.401362198978351,"N"
"3",32030396,32030396,32111461,81065,32070928.5,0.629629629629629,0.30240142306552,"N"
"3",32130228,32130228,32247724,117496,32188976,0.268292682926829,0.14858171994597,"N"
"3",33166233,33166233,33439814,273581,33303023.5,0.4,0.415704387990762,"S"
"3",33439830,33439830,33648009,208179,33543919.5,0.230769230769231,0.161046111493462,"N"
"3",33648013,33648013,33920211,272198,33784112,0.114583333333334,0.128404669260701,"N"
"3",33920639,33920639,34493919,573280,34207279,0.446886446886447,0.348239771646052,"N"
"3",34670863,34670863,35003054,332191,34836958.5,0.0899742930591261,0.105846774193548,"N"
"3",35124075,35124075,35383413,259338,35253744,0.748447204968944,0.205982905982906,"N"
"3",35383419,35383419,35426122,42703,35404770.5,0.76,0.188118811881188,"N"
"3",35426127,35426127,35586305,160178,35506216,0.125,0.119373776908023,"N"
"3",35586329,35586329,35781072,194743,35683700.5,0.157790927021696,0.0983203605079887,"N"
"3",35793483,35793483,35827429,33946,35810456,0.191780821917808,0.320610687022901,"N"
"3",37103497,37103497,37160597,57100,37132047,0.153700189753321,0.153894870170994,"N"
"3",37773401,37773401,37941391,167990,37857396,0.498349834983498,0.299603174603175,"N"
"3",38051397,38051397,39313556,1262159,38682476.5,0.170154686078253,0.286224489795918,"N"
"3",39904404,39904404,39905254,850,39904829,0.0739549839228296,0.255555555555556,"N"
"3",40528510,40528510,40890541,362031,40709525.5,0.0955165692007799,0.0648434053815618,"N"
"3",40890574,40890574,41259920,369346,41075247,0.0628415300546451,0.0763696734919762,"N"
"3",41327458,41327458,41407491,80033,41367474.5,0.257851239669422,0.281927710843373,"N"
"3",41438209,41438209,42085382,647173,41761795.5,0.28881469115192,0.283916849015318,"N"
"3",42085448,42085448,42256736,171288,42171092,0.196460176991151,0.207735495945103,"N"
"3",42296904,42296904,42715134,418230,42506019,0.484210526315789,0.331332533013205,"N"
"3",43527034,43527034,43598172,71138,43562603,0.696652719665272,0.212734241908007,"N"
"3",44094003,44094003,44278934,184931,44186468.5,0.402298850574713,0.169309325450148,"N"
"3",44600363,44600363,44663950,63587,44632156.5,0.418666666666667,0.188023952095809,"N"
"3",44663963,44663963,44665800,1837,44664881.5,0.478048780487805,0.307370622059592,"N"
"3",44665807,44665807,45038238,372431,44852022.5,0.468879668049793,0.187863674147964,"N"
"3",45051285,45051285,45121507,70222,45086396,0.84115523465704,0.623828647925034,"S"
"3",45122746,45122746,45154862,32116,45138804,0.402985074626866,0.461100569259962,"S"
"3",45154870,45154870,45204908,50038,45179889,0.374446552814674,0.375,"N"
"3",45207063,45207063,45265310,58247,45236186.5,0.489263803680982,0.514516129032258,"S"
"3",45265319,45265319,45700330,435011,45482824.5,0.234188034188034,0.315184049079755,"N"
"3",45700357,45700357,45701724,1367,45701040.5,0.262226847034339,0.42905788876277,"S"
"3",45701748,45701748,46132696,430948,45917222,0.251833740831296,0.36611374407583,"N"
"3",46132713,46132713,46558699,425986,46345706,0.335978835978836,0.411447084233261,"S"
"3",46558721,46558721,47334673,775952,46946697,0.238163558106169,0.342032967032967,"N"
"3",47449178,47449178,47558885,109707,47504031.5,0.382022471910112,0.234012044737597,"N"
"3",47558892,47558892,47600969,42077,47579930.5,0.794037940379404,0.442486785804178,"S"
"3",47907920,47907920,47911361,3441,47909640.5,0.049099836333879,0.0916496945010183,"N"
"3",48304735,48304735,48657570,352835,48481152.5,0.320813771517997,0.363690124186872,"N"
"3",48657709,48657709,48922054,264345,48789881.5,0.309192200557103,0.290956749672346,"N"
"3",48922104,48922104,49055752,133648,48988928,0.0869565217391305,0.0821515892420537,"N"
"3",49073907,49073907,49234903,160996,49154405,0.218914185639229,0.151515151515151,"N"
"3",49287377,49287377,49504519,217142,49395948,0.747508305647841,0.306469920544836,"N"
"3",49504535,49504535,49625525,120990,49565030,0.452702702702703,0.303281780460204,"N"
"3",49625534,49625534,50205896,580362,49915715,0.479318734793188,0.26254997778765,"N"
"3",50205897,50205897,50267203,61306,50236550,0.582872928176795,0.313754646840149,"N"
"3",50283041,50283041,50926842,643801,50604941.5,0.297356828193833,0.262645914396887,"N"
"3",50926862,50926862,51147123,220261,51036992.5,0.0280112044817925,0.0433526011560691,"N"
"3",51147289,51147289,51766705,619416,51456997,0.293457943925234,0.270689655172414,"N"
"3",52649858,52649858,52652329,2471,52651093.5,0.122676579925651,0.393638170974155,"N"
"3",52652339,52652339,52653487,1148,52652913,0.0552763819095477,0.234597156398104,"N"
"3",52653617,52653617,52791514,137897,52722565.5,0.176908752327747,0.260989010989011,"N"
"3",52791521,52791521,52955024,163503,52873272.5,0.630534351145038,0.638002059732235,"S"
"3",54601655,54601655,54714197,112542,54657926,0.232815964523282,0.465288035450517,"S"
"3",54714204,54714204,55033524,319320,54873864,0.138576779026217,0.109037328094302,"N"
"3",55033564,55033564,55631958,598394,55332761,0.159533073929961,0.169188445667125,"N"
"3",55632491,55632491,56055988,423497,55844239.5,0.278592375366569,0.252883762200532,"N"
"3",56056002,56056002,56501204,445202,56278603,0.338636363636364,0.35702875399361,"N"
"3",56501218,56501218,56804116,302898,56652667,0.360869565217392,0.266881028938907,"N"
"3",57082454,57082454,57275472,193018,57178963,0.0344827586206897,0.0422783323546682,"N"
"3",57275481,57275481,58015510,740029,57645495.5,0.561584840654608,0.257571767184619,"N"
"3",58015562,58015562,58255072,239510,58135317,0.395759717314488,0.242162162162162,"N"
"3",58255107,58255107,58298947,43840,58277027,0.491166077738516,0.316268486916951,"N"
"3",58299082,58299082,58461179,162097,58380130.5,0.483478260869565,0.40406976744186,"N"
"3",58461180,58461180,58766711,305531,58613945.5,0.379727685325265,0.36767578125,"N"
"3",58767449,58767449,59401523,634074,59084486,0.525581395348837,0.306094808126411,"N"
"3",60240111,60240111,60778172,538061,60509141.5,0.111111111111112,0.0984787830264215,"N"
"3",60778197,60778197,61029245,251048,60903721,0.104199066874028,0.0795409576573013,"N"
"3",61029296,61029296,61242992,213696,61136144,0.944289693593315,0.498529411764706,"S"
"3",61243787,61243787,62116594,872807,61680190.5,0.752665245202559,0.386355344764685,"N"
"3",62116596,62116596,62728128,611532,62422362,0.0324324324324325,0.0326382592928378,"N"
"3",62728187,62728187,63960286,1232099,63344236.5,0.405109489051095,0.321428571428571,"N"
"3",65456603,65456603,65787423,330820,65622013,0.0644329896907219,0.0428326670474017,"N"
"3",65787484,65787484,65884609,97125,65836046.5,0.787155963302752,0.391185410334347,"N"
"3",65884617,65884617,66311560,426943,66098088.5,0.233671988388969,0.28130460104834,"N"
"3",66311581,66311581,66313984,2403,66312782.5,0.209439528023599,0.351485148514852,"N"
"3",66314256,66314256,66315662,1406,66314959,0.0355648535564855,0.139344262295082,"N"
"3",66315673,66315673,66772810,457137,66544241.5,0.692,0.17798353909465,"N"
"3",66772824,66772824,66892325,119501,66832574.5,0.0176211453744495,0.0185042405551274,"N"
"3",67648220,67648220,67935882,287662,67792051,0.513157894736842,0.42416918429003,"S"
"3",71739689,71739689,73169513,1429824,72454601,0.0524934383202101,0.0940438871473354,"N"
"3",74618447,74618447,75960674,1342227,75289560.5,7.21363183512792e-17,3.50270193882585e-16,"N"
"3",75960684,75960684,77167540,1206856,76564112,0.285714285714286,0.36734693877551,"N"
"3",77170828,77170828,78990836,1820008,78080832,0.0310077519379845,0.0342612419700215,"N"
"3",78990837,78990837,80529978,1539141,79760407.5,0.336708860759493,0.407142857142857,"S"
"3",80532461,80532461,81894108,1361647,81213284.5,0.597826086956522,0.713899405083829,"S"
"3",81894547,81894547,83052125,1157578,82473336,0.618670886075949,0.622611464968153,"S"
"3",83056859,83056859,83705198,648339,83381028.5,0.293492695883134,0.490747594374537,"S"
"3",83705276,83705276,85667344,1962068,84686310,0.600985221674877,0.630672027570362,"S"
"3",85667599,85667599,86211508,543909,85939553.5,0.351393188854489,0.346388606307223,"N"
"3",87300089,87300089,87591578,291489,87445833.5,0.0117187499999999,0.0138142747505755,"N"
"3",87723123,87723123,87815084,91961,87769103.5,0.222056631892698,0.158961593172119,"N"
"3",88723597,88723597,88892573,168976,88808085,0.0921052631578946,0.173349056603773,"N"
"3",88894107,88894107,88939960,45853,88917033.5,0.452191235059761,0.501472754050074,"S"
"3",89015411,89015411,89146191,130780,89080801,0.387966804979253,0.366666666666667,"N"
"3",89593178,89593178,89677525,84347,89635351.5,0.41978021978022,0.525206232813932,"S"
"3",90483927,90483927,91348025,864098,90915976,0.300124533001245,0.314758380496299,"N"
"3",91348031,91348031,91496308,148277,91422169.5,0.802693602693603,0.573812580231066,"S"
"3",91497514,91497514,91657835,160321,91577674.5,0.0571428571428572,0.0515970515970514,"N"
"3",91658192,91658192,91938811,280619,91798501.5,0.073025335320417,0.0986577181208056,"N"
"3",92344006,92344006,92635686,291680,92489846,0.231428571428571,0.294010889292196,"N"
"3",92896850,92896850,93452372,555522,93174611,0.286096256684492,0.305423406279734,"N"
"3",93837214,93837214,93993847,156633,93915530.5,0.533240997229917,0.390334572490706,"N"
"3",93993884,93993884,94076387,82503,94035135.5,0.37669376693767,0.382920110192837,"N"
"3",94076515,94076515,94910863,834348,94493689,0.279549718574109,0.226673427991886,"N"
"3",94954206,94954206,95688933,734727,95321569.5,0.644012944983818,0.289314271868185,"N"
"3",95688960,95688960,95880579,191619,95784769.5,0.587248322147651,0.386313465783664,"N"
"3",95880589,95880589,96236795,356206,96058692,0.320825515947467,0.231916817359855,"N"
"3",96236846,96236846,96373339,136493,96305092.5,0.767705382436261,0.554192229038855,"S"
"3",96377129,96377129,96884570,507441,96630849.5,0.11804008908686,0.156188605108055,"N"
"3",97384010,97384010,98183019,799009,97783514.5,0.253067484662577,0.258350730688935,"N"
"3",98183020,98183020,98549532,366512,98366276,0.059659090909091,0.11731843575419,"N"
"3",98549555,98549555,98562801,13246,98556178,0.444043321299639,0.446056210335449,"S"
"3",98562926,98562926,99022314,459388,98792620,0.609550561797753,0.550761421319797,"S"
"3",99022356,99022356,99409637,387281,99215996.5,0.678571428571429,0.585547290116897,"S"
"3",99744516,99744516,100995767,1251251,100370141.5,0.0336426914153132,0.0554493307839388,"N"
"3",101056002,101056002,101469563,413561,101262782.5,0.70479704797048,0.542870677404074,"S"
"3",101469569,101469569,101968794,499225,101719181.5,0.828148148148148,0.548397645519948,"S"
"3",101973374,101973374,102503259,529885,102238316.5,0.903765690376569,0.564656674799582,"S"
"3",102503327,102503327,104018946,1515619,103261136.5,0.823660714285714,0.381067125645439,"N"
"3",104148074,104148074,105843067,1694993,104995570.5,0.331683168316832,0.224706539966462,"N"
"3",105843073,105843073,106215603,372530,106029338,0.276712328767123,0.200132100396301,"N"
"3",106216420,106216420,106417798,201378,106317109,0.0778985507246377,0.123800383877159,"N"
"3",106421161,106421161,107530201,1109040,106975681,0.0730337078651685,0.111216730038023,"N"
"3",107531461,107531461,107750055,218594,107640758,0.44949494949495,0.283740701381509,"N"
"3",107750129,107750129,108613926,863797,108182027.5,0.160828025477707,0.167310877967973,"N"
"3",108799992,108799992,108805161,5169,108802576.5,0.789473684210526,0.346153846153846,"N"
"3",108805191,108805191,108848985,43794,108827088,0.505226480836237,0.280193236714976,"N"
"3",108848989,108848989,109048938,199949,108948963.5,0.883720930232558,0.352123552123552,"N"
"3",109048949,109048949,109066134,17185,109057541.5,0.855855855855856,0.354257302672467,"N"
"3",109066170,109066170,109229489,163319,109147829.5,0.523364485981308,0.342019543973941,"N"
"3",109229494,109229494,109230779,1285,109230136.5,0.174137931034482,0.430397727272727,"S"
"3",109381722,109381722,109407009,25287,109394365.5,0.441908713692946,0.430883344571814,"S"
"3",109407011,109407011,109407613,602,109407312,0.17948717948718,0.434713375796179,"S"
"3",109691790,109691790,110286900,595110,109989345,0.299065420560748,0.231790744466801,"N"
"3",110575405,110575405,110700615,125210,110638010,0.622889305816135,0.600241060666934,"S"
"3",110700617,110700617,110826313,125696,110763465,0.308928571428571,0.533401849948613,"S"
"3",110978035,110978035,111859591,881556,111418813,0.474912485414236,0.595900439238653,"S"
"3",111877684,111877684,112485313,607629,112181498.5,0.0543735224586287,0.0862499999999998,"N"
"3",113663023,113663023,113797865,134842,113730444,0.0704225352112677,0.176056338028169,"N"
"3",113915877,113915877,113916744,867,113916310.5,0.0215053763440859,0.0670391061452514,"N"
"3",115285847,115285847,115751536,465689,115518691.5,0.162835249042145,0.440414507772021,"S"
"3",115751538,115751538,115762480,10942,115757009,0.0363636363636365,0.155844155844156,"N"
"3",116542904,116542904,116762333,219429,116652618.5,0.0826873385012924,0.149068322981367,"N"
"3",117861300,117861300,118494665,633365,118177982.5,0.265753424657534,0.18957654723127,"N"
"3",118494993,118494993,119096426,601433,118795709.5,0.16188524590164,0.105473965287049,"N"
"3",119149923,119149923,119654467,504544,119402195,0.175654853620955,0.293814432989691,"N"
"3",119654503,119654503,119690174,35671,119672338.5,0.28395061728395,0.256863657515123,"N"
"3",119692779,119692779,119698996,6217,119695887.5,0.504761904761904,0.411384217335058,"S"
"3",119699060,119699060,120137904,438844,119918482,0.330024813895781,0.238066825775656,"N"
"3",121257035,121257035,121440334,183299,121348684.5,0.292063492063492,0.402332361516035,"N"
"3",121458113,121458113,121646602,188489,121552357.5,0.00530035335689068,0.00541842263696579,"N"
"3",122123286,122123286,122397727,274441,122260506.5,0.671052631578948,0.2448,"N"
"3",122397883,122397883,122617789,219906,122507836,0.682119205298013,0.393046427814289,"N"
"3",122617931,122617931,122841944,224013,122729937.5,0.818908122503329,0.595545513234345,"S"
"3",122842086,122842086,122931496,89410,122886791,0.559633027522936,0.572386058981233,"S"
"3",122931515,122931515,123285673,354158,123108594,0.486301369863014,0.324571428571429,"N"
"3",123285683,123285683,123347343,61660,123316513,0.165071770334928,0.161971830985916,"N"
"3",123369776,123369776,123860372,490596,123615074,0.136268343815514,0.13448275862069,"N"
"3",123860867,123860867,125292253,1431386,124576560,0.0120240480961923,0.0150375939849624,"N"
"3",125294092,125294092,126173428,879336,125733760,0.75990675990676,0.588447653429603,"S"
"3",126173463,126173463,126466721,293258,126320092,0.559633027522936,0.234115138592751,"N"
"3",127237595,127237595,127321941,84346,127279768,0.0173697270471467,0.0103499260719567,"N"
"3",127504522,127504522,127719581,215059,127612051.5,0.12379421221865,0.191701244813278,"N"
"3",127719586,127719586,128254287,534701,127986936.5,0.439285714285714,0.494638069705093,"S"
"3",128254708,128254708,128683745,429037,128469226.5,0.594392523364486,0.368766911480479,"N"
"3",128684873,128684873,128812597,127724,128748735,0.389473684210526,0.271062271062271,"N"
"3",128812611,128812611,128845536,32925,128829073.5,0.322222222222222,0.214074803149606,"N"
"3",128845540,128845540,128861548,16008,128853544,0.26061776061776,0.248466257668712,"N"
"3",128861569,128861569,128890659,29090,128876114,0.534883720930233,0.386121992165641,"N"
"3",128890698,128890698,128992322,101624,128941510,0.156398104265403,0.177498879426266,"N"
"3",128992330,128992330,129182156,189826,129087243,0.69061876247505,0.348322147651007,"N"
"3",129186337,129186337,129586410,400073,129386373.5,0.0342577487765088,0.0285326086956521,"N"
"3",129587964,129587964,129993689,405725,129790826.5,0.0657894736842107,0.065359477124183,"N"
"3",130197977,130197977,130272795,74818,130235386,0.057627118644068,0.0335415981585006,"N"
"3",130272904,130272904,130679881,406977,130476392.5,0.100702576112412,0.0900837988826816,"N"
"3",131052616,131052616,131112131,59515,131082373.5,0.258883248730965,0.198314970836034,"N"
"3",131112138,131112138,131372388,260250,131242263,0.316931982633864,0.265026220250101,"N"
"3",131745122,131745122,132150612,405490,131947867,0.0997679814385151,0.0567781690140844,"N"
"3",132150912,132150912,132291257,140345,132221084.5,0.44258872651357,0.190476190476191,"N"
"3",132291279,132291279,132294581,3302,132292930,0.756302521008403,0.345710627400768,"N"
"3",132478654,132478654,132640094,161440,132559374,0.254504504504504,0.386986301369863,"N"
"3",132651963,132651963,132935575,283612,132793769,0.411764705882353,0.224199288256228,"N"
"3",132935641,132935641,132940868,5227,132938254.5,0.247264770240701,0.28391959798995,"N"
"3",132940873,132940873,133055551,114678,132998212,0.192214111922141,0.207167832167832,"N"
"3",133055624,133055624,133102378,46754,133079001,0.7,0.221709006928407,"N"
"3",133102415,133102415,133115564,13149,133108989.5,0.626865671641791,0.346673336668334,"N"
"3",133116508,133116508,133203602,87094,133160055,0.865092748735244,0.369419107057129,"N"
"3",133203604,133203604,133234309,30705,133218956.5,0.663551401869159,0.211309523809524,"N"
"3",133234316,133234316,133379043,144727,133306679.5,0.639563106796117,0.524900398406375,"S"
"3",133380312,133380312,133482328,102016,133431320,0.904610492845787,0.769438810006761,"S"
"3",133516397,133516397,133543732,27335,133530064.5,0.766081871345029,0.199847444698703,"N"
"3",133643715,133643715,133808160,164445,133725937.5,0.242352941176471,0.111231101511879,"N"
"3",133808717,133808717,134040952,232235,133924834.5,0.147859922178988,0.126455906821963,"N"
"3",134040990,134040990,134818028,777038,134429509,0.15257048092869,0.13953488372093,"N"
"3",134818029,134818029,134841118,23089,134829573.5,0.258064516129032,0.204448651206815,"N"
"3",134841389,134841389,134940821,99432,134891105,0.111650485436894,0.0651558073654391,"N"
"3",134940894,134940894,135118641,177747,135029767.5,0.296442687747036,0.221674876847291,"N"
"3",135126557,135126557,135179473,52916,135153015,0.0714285714285714,0.0851187029530978,"N"
"3",135179514,135179514,135316929,137415,135248221.5,0.410764872521246,0.288270377733598,"N"
"3",135317331,135317331,135473934,156603,135395632.5,0.670816044260028,0.550927678909504,"S"
"3",135473973,135473973,135792070,318097,135633021.5,0.833693304535637,0.623083131557708,"S"
"3",135792135,135792135,135935465,143330,135863800,0.53641933287951,0.486219662690251,"S"
"3",135935710,135935710,135967638,31928,135951674,0.732467532467532,0.526446795270691,"S"
"3",135967643,135967643,136436564,468921,136202103.5,0.170731707317073,0.135265700483092,"N"
"3",136437165,136437165,136452793,15628,136444979,0.264150943396226,0.113667117726657,"N"
"3",136483469,136483469,136584909,101440,136534189,0.55893536121673,0.223630831643002,"N"
"3",136885544,136885544,136914192,28648,136899868,0.483582089552239,0.381775333857031,"N"
"3",136914211,136914211,137133785,219574,137023998,0.493197278911564,0.318448023426061,"N"
"3",137134063,137134063,137254167,120104,137194115,0.91869918699187,0.375664893617021,"N"
"3",137254175,137254175,137553501,299326,137403838,0.173333333333333,0.134193548387097,"N"
"3",137553875,137553875,138359012,805137,137956443.5,0.13855421686747,0.100546448087432,"N"
"3",138797979,138797979,138910301,112322,138854140,0.652,0.296543359611886,"N"
"3",138910304,138910304,139187836,277532,139049070,0.674641148325359,0.178105263157895,"N"
"3",140029065,140029065,140440599,411534,140234832,0.257281553398058,0.285971223021583,"N"
"3",140440672,140440672,140638088,197416,140539380,0.0403225806451613,0.082079343365253,"N"
"3",140638093,140638093,140807973,169880,140723033,0.122052704576976,0.162162162162162,"N"
"3",140818252,140818252,141234989,416737,141026620.5,0.186507936507937,0.261595547309833,"N"
"3",141235007,141235007,141347418,112411,141291212.5,0.345381526104418,0.533057851239669,"S"
"3",142727173,142727173,143539917,812744,143133545,0.141496598639456,0.165869218500798,"N"
"3",143539925,143539925,144112900,572975,143826412.5,0.252713178294574,0.306390977443609,"N"
"3",144112919,144112919,144441489,328570,144277204,0.217391304347826,0.165103954341623,"N"
"3",144441535,144441535,144719064,277529,144580299.5,0.333333333333333,0.300650054171181,"N"
"3",144719371,144719371,144728875,9504,144724123,0.496221662468514,0.298711144806672,"N"
"3",144728961,144728961,145367526,638565,145048243.5,0.045602605863192,0.0482758620689655,"N"
"3",145367588,145367588,145512331,144743,145439959.5,0.541818181818182,0.378974141585417,"N"
"3",145512332,145512332,145797835,285503,145655083.5,0.135802469135802,0.145775814467145,"N"
"3",145916000,145916000,145938921,22921,145927460.5,0.470588235294118,0.216949152542373,"N"
"3",146068522,146068522,146575930,507408,146322226,0.158854166666667,0.131465517241379,"N"
"3",146576209,146576209,146732333,156124,146654271,0.312236286919831,0.210526315789474,"N"
"3",146819954,146819954,147217785,397831,147018869.5,0.209424083769633,0.250347705146036,"N"
"3",147217811,147217811,147508951,291140,147363381,0.018987341772152,0.014268727705113,"N"
"3",148281589,148281589,148444413,162824,148363001,0.782828282828283,0.336712527154236,"N"
"3",148444764,148444764,148603449,158685,148524106.5,0.144554455445544,0.277566539923954,"N"
"3",148603692,148603692,148687124,83432,148645408,0.393115942028985,0.436619718309859,"S"
"3",148687140,148687140,149270233,583093,148978686.5,0.33034379671151,0.253053435114504,"N"
"3",149271895,149271895,149446758,174863,149359326.5,0.461300309597523,0.344110854503464,"N"
"3",149446778,149446778,149964333,517555,149705555.5,0.379310344827586,0.436003303055326,"S"
"3",149964349,149964349,150008383,44034,149986366,0.345514950166113,0.55417406749556,"S"
"3",150008388,150008388,150435699,427311,150222043.5,0.390202702702703,0.375,"N"
"3",150435732,150435732,150821429,385697,150628580.5,0.357894736842105,0.488817891373802,"S"
"3",150821459,150821459,151497525,676066,151159492,0.641114982578397,0.365320979483785,"N"
"3",151644854,151644854,152415126,770272,152029990,0.130641330166271,0.0953757225433527,"N"
"3",152493087,152493087,152542414,49327,152517750.5,0.415458937198068,0.230769230769231,"N"
"3",152816768,152816768,152874945,58177,152845856.5,0.262195121951219,0.490494296577947,"S"
"3",153856148,153856148,153973139,116991,153914643.5,0.806763285024155,0.259451061626101,"N"
"3",153973154,153973154,154600923,627769,154287038.5,0.204588910133843,0.129019292604502,"N"
"3",154600941,154600941,154709546,108605,154655243.5,0.660079051383399,0.26727127233929,"N"
"3",154709666,154709666,154772357,62691,154741011.5,0.86865671641791,0.359185352808064,"N"
"3",154773081,154773081,155423400,650319,155098240.5,0.458333333333333,0.224842767295598,"N"
"3",155426767,155426767,155669999,243232,155548383,0.458661417322834,0.22071360909378,"N"
"3",155840464,155840464,156017533,177069,155928998.5,0.215106732348112,0.195134061569017,"N"
"3",156017612,156017612,156328023,310411,156172817.5,0.124812030075188,0.110372340425532,"N"
"3",156438185,156438185,156679390,241205,156558787.5,0.0902777777777772,0.0928129462160878,"N"
"3",157248954,157248954,157779778,530824,157514366,0.497206703910615,0.239247311827957,"N"
"3",157780467,157780467,158087333,306866,157933900,0.601583113456464,0.338613861386139,"N"
"3",158087348,158087348,158486253,398905,158286800.5,0.519950124688279,0.518227009113505,"S"
"3",158492345,158492345,158942608,450263,158717476.5,0.304449648711944,0.186201957507758,"N"
"3",159857558,159857558,160075579,218021,159966568.5,0.173134328358209,0.151633986928105,"N"
"3",160075646,160075646,160369106,293460,160222376,0.442658092175777,0.362068965517241,"N"
"3",160369454,160369454,160794898,425444,160582176,0.160161507402422,0.132124352331606,"N"
"3",160795330,160795330,161132621,337291,160963975.5,0.244274809160305,0.242792109256449,"N"
"3",161132657,161132657,161602651,469994,161367654,0.159090909090909,0.216757741347905,"N"
"3",161743919,161743919,161772644,28725,161758281.5,0.098360655737705,0.280155642023346,"N"
"3",161772648,161772648,162355216,582568,162063932,0.3886925795053,0.272614622057001,"N"
"3",163911387,163911387,164523681,612294,164217534,1.42583826573933e-16,1.20322600050999e-16,"N"
"3",164523683,164523683,165007706,484023,164765694.5,0.493775933609958,0.304088586030664,"N"
"3",165493848,165493848,165899674,405826,165696761,0.404651162790698,0.319070904645477,"N"
"3",165908065,165908065,166005958,97893,165957011.5,0.492455418381344,0.383137673425827,"N"
"3",166006023,166006023,166137861,131838,166071942,0.76800748362956,0.681704954331581,"S"
"3",166138271,166138271,166292562,154291,166215416.5,0.402332361516035,0.263191354100445,"N"
"3",166439269,166439269,166706017,266748,166572643,0.206713780918727,0.209802749551704,"N"
"3",166797182,166797182,166798087,905,166797634.5,0.0057581573896354,0.0358565737051789,"N"
"3",166798092,166798092,166799344,1252,166798718,0.072340425531915,0.373626373626374,"N"
"3",166799353,166799353,166800000,647,166799676.5,0.0131578947368421,0.123529411764706,"N"
"3",167118898,167118898,167516055,397157,167317476.5,0.278443113772455,0.203501094091904,"N"
"3",167516070,167516070,167708606,192536,167612338,0.242424242424242,0.306755934266586,"N"
"3",167708701,167708701,168052837,344136,167880769,0.375474083438685,0.31640625,"N"
"3",168052901,168052901,168276760,223859,168164830.5,0.638392857142857,0.684210526315789,"S"
"3",168276946,168276946,168338647,61701,168307796.5,0.290874524714829,0.330930064888248,"N"
"3",168338743,168338743,168414359,75616,168376551,0.324492979719189,0.303501945525292,"N"
"3",168414677,168414677,169075778,661101,168745227.5,0.227405247813411,0.155740432612313,"N"
"3",169075789,169075789,169355493,279704,169215641,0.153846153846154,0.10038240917782,"N"
"3",169355502,169355502,169660623,305121,169508062.5,0.493282149712092,0.474753694581281,"S"
"3",169660870,169660870,170064040,403170,169862455,0.242732558139535,0.25137982940291,"N"
"3",170202052,170202052,170262428,60376,170232240,0.0730688935281836,0.14726507713885,"N"
"3",170262437,170262437,170502971,240534,170382704,0.538461538461539,0.396359959555106,"N"
"3",170503440,170503440,170756704,253264,170630072,0.493421052631579,0.378045365443853,"N"
"3",170756768,170756768,170911105,154337,170833936.5,0.619469026548672,0.374331550802139,"N"
"3",170946718,170946718,171193073,246355,171069895.5,0.202453987730062,0.14585635359116,"N"
"3",171193184,171193184,171488394,295210,171340789,0.176684881602914,0.176470588235294,"N"
"3",171488661,171488661,171757504,268843,171623082.5,0.251633986928104,0.217514124293785,"N"
"3",171757512,171757512,172374401,616889,172065956.5,0.173501577287066,0.123595505617978,"N"
"3",172374981,172374981,172419297,44316,172397139,0.270029673590505,0.221590909090909,"N"
"3",172419299,172419299,172502805,83506,172461052,0.327935222672065,0.161622879946791,"N"
"3",172502818,172502818,172518615,15797,172510716.5,0.456066945606695,0.230687830687831,"N"
"3",172611565,172611565,172671377,59812,172641471,0.321428571428571,0.167053364269142,"N"
"3",172671734,172671734,173247118,575384,172959426,0.29783693843594,0.273700305810398,"N"
"3",173423622,173423622,173698360,274738,173560991,0.113432835820895,0.1216,"N"
"3",173699469,173699469,174400478,701009,174049973.5,0.495774647887324,0.347140039447732,"N"
"3",174502011,174502011,174723239,221228,174612625,0.441580756013746,0.520770010131712,"S"
"3",175207645,175207645,175208923,1278,175208284,0.0924731182795697,0.260606060606061,"N"
"3",175602684,175602684,175631017,28333,175616850.5,0.326219512195122,0.362916902204635,"N"
"3",176333635,176333635,176477736,144101,176405685.5,0.227513227513228,0.19585020242915,"N"
"3",176477801,176477801,176570171,92370,176523986,0.216842105263158,0.185029940119761,"N"
"3",176570203,176570203,176841439,271236,176705821,0.374087591240876,0.169842584921293,"N"
"3",176841717,176841717,177207578,365861,177024647.5,0.678824721377913,0.471277842907386,"S"
"3",177211770,177211770,177599962,388192,177405866,0.642857142857143,0.452119309262166,"S"
"3",177599967,177599967,177818864,218897,177709415.5,0.219178082191781,0.21021897810219,"N"
"3",177818908,177818908,178201332,382424,178010120,0.124314442413163,0.193364928909952,"N"
"3",178203462,178203462,178588281,384819,178395871.5,0.173780487804878,0.17440081591025,"N"
"3",178832750,178832750,179119362,286612,178976056,0.20447284345048,0.217563739376771,"N"
"3",179276660,179276660,179661211,384551,179468935.5,0.214285714285714,0.137462876537972,"N"
"3",179661231,179661231,179696745,35514,179678988,0.0103986135181974,0.0169651272384545,"N"
"3",179696763,179696763,179838900,142137,179767831.5,0.483558994197292,0.259965337954939,"N"
"3",179838904,179838904,179916399,77495,179877651.5,0.741992882562277,0.401992287917738,"N"
"3",180007921,180007921,180060520,52599,180034220.5,0.364795918367346,0.300420168067227,"N"
"3",180060528,180060528,180161128,100600,180110828,0.715705765407555,0.50561797752809,"S"
"3",181026179,181026179,181057225,31046,181041702,0.299610894941634,0.374392220421394,"N"
"3",181057598,181057598,181247040,189442,181152319,0.457883369330453,0.248534583821805,"N"
"3",181247062,181247062,181742023,494961,181494542.5,0.0337837837837839,0.0188264825855037,"N"
"3",181742031,181742031,181817425,75394,181779728,0.439882697947214,0.25626423690205,"N"
"3",182132473,182132473,182463578,331105,182298025.5,0.312997347480107,0.145499383477189,"N"
"3",182676793,182676793,182812864,136071,182744828.5,0.293877551020408,0.233387358184765,"N"
"3",182832854,182832854,183151119,318265,182991986.5,0.208053691275168,0.131728045325779,"N"
"3",183151174,183151174,183498463,347289,183324818.5,0.459654178674351,0.426280623608018,"S"
"3",183518354,183518354,183922805,404451,183720579.5,0.409722222222222,0.269680040629761,"N"
"3",184327560,184327560,184374222,46662,184350891,0.447916666666667,0.400621118012422,"N"
"3",184374275,184374275,184736875,362600,184555575,0.23680649526387,0.198487712665406,"N"
"3",184964584,184964584,184990107,25523,184977345.5,0.628,0.465645081562036,"S"
"3",184990111,184990111,185090702,100591,185040406.5,0.306451612903226,0.225551158846806,"N"
"3",185091111,185091111,185332160,241049,185211635.5,0.0910425844346545,0.100649350649351,"N"
"3",185363410,185363410,185742845,379435,185553127.5,0.074875207986689,0.0765306122448981,"N"
"3",186262102,186262102,186440786,178684,186351444,0.311178247734139,0.238150289017341,"N"
"3",186440862,186440862,186603209,162347,186522035.5,0.501639344262295,0.340378197997775,"N"
"3",186603398,186603398,186808810,205412,186706104,0.64769647696477,0.72521915037087,"S"
"3",186808991,186808991,186900566,91575,186854778.5,0.0574018126888221,0.0510523958799822,"N"
"3",186903695,186903695,187107685,203990,187005690,0.0485762144053599,0.0521270221689634,"N"
"3",187512066,187512066,187779131,267065,187645598.5,0.057943925233645,0.0417040358744396,"N"
"3",187779153,187779153,188076246,297093,187927699.5,0.369230769230769,0.25296442687747,"N"
"3",188334203,188334203,188627631,293428,188480917,0.0864946889226102,0.0871559633027524,"N"
"3",189305931,189305931,189710165,404234,189508048,0.430939226519337,0.405370290168904,"N"
"3",189712426,189712426,189905259,192833,189808842.5,0.217041800643087,0.127038895859473,"N"
"3",190285243,190285243,190844175,558932,190564709,0.0452488687782805,0.0516573396470081,"N"
"3",190844288,190844288,191152100,307812,190998194,0.294751009421265,0.393884892086331,"N"
"3",191152135,191152135,191172475,20340,191162305,0.130693069306931,0.187855787476281,"N"
"3",191172483,191172483,191198725,26242,191185604,0.109619686800895,0.123373898447335,"N"
"3",191198757,191198757,191215018,16261,191206887.5,0.287022900763359,0.523191094619666,"S"
"3",191215082,191215082,191262149,47067,191238615.5,0.826335877862596,0.644825018615041,"S"
"3",191262226,191262226,191363518,101292,191312872,0.219110378912685,0.291240875912409,"N"
"3",191762647,191762647,192179287,416640,191970967,0.0379241516966068,0.0236809306190278,"N"
"3",192179288,192179288,192287040,107752,192233164,0.158469945355191,0.178828365878726,"N"
"3",192287044,192287044,192391013,103969,192339028.5,0.0739910313901342,0.095100864553314,"N"
"3",192391040,192391040,192847622,456582,192619331,0.311188811188811,0.230569948186528,"N"
"3",193821695,193821695,194104159,282464,193962927,0.382352941176471,0.356001825650388,"N"
"3",194104251,194104251,194400394,296143,194252322.5,0.658823529411765,0.25,"N"
"3",194400455,194400455,194543321,142866,194471888,0.0085470085470087,0.00698486612339938,"N"
"3",194543341,194543341,194795225,251884,194669283,0.0027397260273974,0.00170164492342611,"N"
"3",194818665,194818665,195062981,244316,194940823,0.144508670520231,0.105932203389831,"N"
"3",195063191,195063191,195481118,417927,195272154.5,0.00701754385964895,0.00702165008777032,"N"
"3",195481474,195481474,195668067,186593,195574770.5,0.167532467532468,0.173154362416107,"N"
"3",195668175,195668175,195759673,91498,195713924,0.0142602495543676,0.00909090909090937,"N"
"3",195762232,195762232,196005880,243648,195884056,0.461412151067323,0.261719962744489,"N"
"3",196005971,196005971,196209120,203149,196107545.5,0.127582017010935,0.122045718713677,"N"
"3",196210382,196210382,196417955,207573,196314168.5,0.21285140562249,0.208387942332896,"N"
"3",197100854,197100854,197581564,480710,197341209,0.05,0.0441347270615563,"N"
"3",197852004,197852004,198597742,745738,198224873,0.516587677725118,0.261809447558046,"N"
"3",198598213,198598213,198673001,74788,198635607,0.133986928104575,0.126348228043143,"N"
"3",198673366,198673366,198984762,311396,198829064,0.323943661971831,0.314271255060729,"N"
"3",198984768,198984768,199145159,160391,199064963.5,0.567664670658683,0.503541076487252,"S"
"3",199145529,199145529,199562287,416758,199353908,0.466340269277846,0.430995475113122,"S"
"3",199724045,199724045,199902064,178019,199813054.5,0.156390977443609,0.147937411095306,"N"
"3",199902168,199902168,200259745,357577,200080956.5,0.283116883116883,0.296598639455782,"N"
"3",200261142,200261142,200479615,218473,200370378.5,0.432835820895522,0.4088772845953,"S"
"3",200479626,200479626,200480880,1254,200480253,0.51440329218107,0.335120643431636,"N"
"3",200480881,200480881,200611329,130448,200546105,0.0463215258855584,0.0481132075471697,"N"
"3",200611344,200611344,200836260,224916,200723802,0.154580152671756,0.159658344283837,"N"
"3",200836263,200836263,200930104,93841,200883183.5,0.379174852652259,0.20879913451136,"N"
"3",201121077,201121077,201452666,331589,201286871.5,0.204697986577181,0.200218818380744,"N"
"3",201452787,201452787,201673078,220291,201562932.5,0.106732348111659,0.0851900393184797,"N"
"3",202061962,202061962,202435913,373951,202248937.5,0.0325670498084293,0.0591647331786545,"N"
"3",202435952,202435952,202832368,396416,202634160,0.342342342342342,0.350230414746544,"N"
"3",202832384,202832384,203004241,171857,202918312.5,0.147385103011093,0.142129393785023,"N"
"3",203004586,203004586,203020848,16262,203012717,0.295681063122924,0.238286479250335,"N"
"3",203020989,203020989,203224495,203506,203122742,0.564853556485356,0.288873038516405,"N"
"3",203224537,203224537,203360554,136017,203292545.5,0.742081447963801,0.233729216152019,"N"
"3",203560945,203560945,203562457,1512,203561701,0.0232558139534884,0.933333333333333,"S"
"3",203562458,203562458,203578374,15916,203570416,0.14,0.411092985318108,"S"
"3",204166030,204166030,204492767,326737,204329398.5,0.207667731629393,0.176950998185118,"N"
"3",204505707,204505707,204659974,154267,204582840.5,0.0681818181818185,0.0823943661971834,"N"
"3",204660010,204660010,204700351,40341,204680180.5,0.554785020804438,0.53475935828877,"S"
"3",204700985,204700985,204736165,35180,204718575,0.575384615384615,0.531501657981999,"S"
"3",204736173,204736173,205177645,441472,204956909,0.166666666666667,0.186627906976745,"N"
"3",205177668,205177668,205646121,468453,205411894.5,0.10662177328844,0.0974025974025975,"N"
"3",205669280,205669280,205670213,933,205669746.5,0.228971962616823,0.380336351875809,"N"
"3",205670221,205670221,205670730,509,205670475.5,0.151927437641723,0.506297229219144,"S"
"3",205670744,205670744,205895758,225014,205783251,0.251141552511416,0.227900552486188,"N"
"3",205896103,205896103,206047083,150980,205971593,0.352094240837697,0.281970649895179,"N"
"3",206622844,206622844,207009641,386797,206816242.5,0.56606397774687,0.325513196480938,"N"
"3",208494784,208494784,208548617,53833,208521700.5,0.167785234899329,0.390117035110533,"N"
"3",208700886,208700886,208738215,37329,208719550.5,0.438532110091743,0.391375545851528,"N"
"3",208738237,208738237,208863748,125511,208800992.5,0.293966623876765,0.298695652173913,"N"
"3",209224150,209224150,209546021,321871,209385085.5,0.623456790123457,0.574589127686473,"S"
"3",209546426,209546426,210132461,586035,209839443.5,0.218978102189781,0.230179028132992,"N"
"3",210185030,210185030,210221448,36418,210203239,0.820610687022901,0.697485806974858,"S"
"3",210313964,210313964,210657155,343191,210485559.5,0.607655502392344,0.244701348747592,"N"
"3",210666241,210666241,210906112,239871,210786176.5,0.163366336633663,0.124111993313832,"N"
"3",210906144,210906144,210929081,22937,210917612.5,0.093877551020408,0.293617021276596,"N"
"3",212064346,212064346,212245320,180974,212154833,0.350553505535055,0.271084337349398,"N"
"3",212245355,212245355,212500749,255394,212373052,0.452328159645233,0.480754124116261,"S"
"3",212501608,212501608,212632172,130564,212566890,0.152722443559097,0.262757044935262,"N"
"3",212632549,212632549,212786266,153717,212709407.5,0.242718446601942,0.171849427168576,"N"
"3",214065758,214065758,214279412,213654,214172585,0.00823045267489727,0.00880410858400598,"N"
"3",214279430,214279430,214556907,277477,214418168.5,0.618729096989967,0.253366811230313,"N"
"3",214558189,214558189,214934566,376377,214746377.5,0.160762942779292,0.110937010341586,"N"
"3",214934612,214934612,215157408,222796,215046010,0.208791208791209,0.212984586641756,"N"
"3",215180283,215180283,215396702,216419,215288492.5,0.535822401614531,0.506518282988871,"S"
"3",215397156,215397156,215674878,277722,215536017,0.366473988439306,0.353926311871976,"N"
"3",215675647,215675647,215831598,155951,215753622.5,0.123239436619718,0.110935023771791,"N"
"3",215942318,215942318,216325859,383541,216134088.5,0.469359331476323,0.259031514219831,"N"
"3",216729488,216729488,216952143,222655,216840815.5,0.330592105263158,0.250103691414351,"N"
"3",216952215,216952215,217220286,268071,217086250.5,0.656015037593985,0.393313298271976,"N"
"3",217220400,217220400,217255038,34638,217237719,0.0960451977401128,0.105590062111801,"N"
"3",217255072,217255072,217330203,75131,217292637.5,0.736842105263158,0.36742934051144,"N"
"3",217330210,217330210,217447511,117301,217388860.5,0.35969868173258,0.358797745773325,"N"
"3",217500382,217500382,217719329,218947,217609855.5,0.370870870870871,0.281856219094713,"N"
"3",218353531,218353531,218361646,8115,218357588.5,0.0966542750929368,0.130543933054393,"N"
"3",218361669,218361669,218566046,204377,218463857.5,0.4375,0.302884615384615,"N"
"3",218566225,218566225,218869460,303235,218717842.5,0.28665568369028,0.252052148720425,"N"
"3",219457109,219457109,219509158,52049,219483133.5,0.236139630390144,0.257270693512305,"N"
"3",219665706,219665706,219700072,34366,219682889,0.354609929078014,0.282618935468676,"N"
"3",219700232,219700232,219871776,171544,219786004,0.190388170055453,0.167752442996743,"N"
"3",220378544,220378544,220606421,227877,220492482.5,0.189226519337017,0.19683908045977,"N"
"3",220763267,220763267,220930295,167028,220846781,0.215411558669002,0.185987903225807,"N"
"3",220930310,220930310,220933236,2926,220931773,0.0591603053435114,0.208520179372197,"N"
"3",220933281,220933281,221303695,370414,221118488,0.00903614457831319,0.0107270560190705,"N"
"3",221303707,221303707,221304809,1102,221304258,0.0476190476190476,0.266666666666667,"N"
"3",221488598,221488598,221665601,177003,221577099.5,0.241435562805873,0.367245657568238,"N"
"3",221666419,221666419,221764143,97724,221715281,0.43859649122807,0.254309126871998,"N"
"3",222035597,222035597,222517549,481952,222276573,0.377952755905512,0.130671506352087,"N"
"3",222522523,222522523,222562417,39894,222542470,0.712082262210797,0.182717678100264,"N"
"3",222562422,222562422,222812983,250561,222687702.5,0.416879795396419,0.20511744966443,"N"
"3",223182458,223182458,223265001,82543,223223729.5,0.707602339181286,0.421113689095128,"S"
"3",223265007,223265007,223650159,385152,223457583,0.373942470389171,0.376918703808983,"N"
"3",223650166,223650166,223828506,178340,223739336,0.660919540229885,0.444778685002149,"S"
"3",223828507,223828507,223839505,10998,223834006,0.801724137931035,0.418447694038245,"S"
"3",223839846,223839846,224079725,239879,223959785.5,0.267272727272727,0.240589198036006,"N"
"3",224079893,224079893,224551849,471956,224315871,0.511502029769959,0.274909090909091,"N"
"3",224552128,224552128,224587537,35409,224569832.5,0.476595744680851,0.229900786862812,"N"
"3",224588323,224588323,224676922,88599,224632622.5,0.0209973753280836,0.0275229357798165,"N"
"3",225009513,225009513,225211453,201940,225110483,0.294207317073171,0.317173377156943,"N"
"3",225388914,225388914,225428407,39493,225408660.5,0.33420365535248,0.288830387363671,"N"
"3",225438336,225438336,225674312,235976,225556324,0.250334672021419,0.268935762224353,"N"
"3",225688363,225688363,225844199,155836,225766281,0.0822510822510823,0.247826086956522,"N"
"3",225844204,225844204,226194497,350293,226019350.5,0.12156862745098,0.095679012345679,"N"
"3",226221599,226221599,226352563,130964,226287081,0.645374449339207,0.47941096263976,"S"
"3",226352586,226352586,226654767,302181,226503676.5,0.183544303797468,0.121254355400697,"N"
"3",227897900,227897900,228029888,131988,227963894,0.546142208774584,0.421564811210588,"S"
"3",228030393,228030393,228491600,461207,228260996.5,0.523136246786633,0.537648612945839,"S"
"3",228491607,228491607,228710379,218772,228600993,0.198443579766537,0.214435879467414,"N"
"3",228710718,228710718,228975280,264562,228842999,0.283643892339545,0.24435196195006,"N"
"3",229071791,229071791,229330621,258830,229201206,0.244897959183673,0.138417173982698,"N"
"3",229332324,229332324,229475420,143096,229403872,0.0410958904109588,0.0512455516014234,"N"
"3",229657591,229657591,229684442,26851,229671016.5,0.16,0.159917990773962,"N"
"3",229990305,229990305,230085126,94821,230037715.5,0.236016371077762,0.2190797804981,"N"
"3",230088383,230088383,230246763,158380,230167573,0.413098236775819,0.397575757575758,"N"
"3",230246778,230246778,230311328,64550,230279053,0.254945054945054,0.258639910813824,"N"
"3",230311333,230311333,230335383,24050,230323358,0.165938864628821,0.218390804597701,"N"
"3",230335423,230335423,230339129,3706,230337276,0.247606019151846,0.309931506849315,"N"
"3",230706695,230706695,230867756,161061,230787225.5,0.0567164179104474,0.0429540316503388,"N"
"3",230995547,230995547,231200163,204616,231097855,0.196452933151432,0.336973478939157,"N"
"3",231200177,231200177,231760349,560172,231480263,0.0349264705882351,0.0696821515892418,"N"
